1111111111111111
100C000000000001
1001110111100001
1000000000P00001
1110111011101111
1C0000010000C1E1
1111011110111101
1001000010100101
1011110010101101
100000C000000001
1111111111111111