111111
1P0E11
111111
1C0011
111111
