11111
1P0C1
11101
10011
11111
11111
10001
11101
100E1
11111
